XXXXXXXXXXXXXXXXXXXXXXXXXXXXXXXXXXXXXXXXXXXXXXXXXXXXXXXXXXXXXXXXXXXXXXXXXXXXX
QBZZSZBZZBZZBZBZZBZZBZZBZZBZZBZZZBZZBZZBZZXXXXBZZZBZZZBZZZBZZZBZZZBZZZZZZZZZQ
QZZZZZZZZZZZZZZZZZZZZZZZZZZZZZZZZZZZZZZZZZXXXXZZZZZZZZZZZZZZZZZZZZZZZZZZZXXXQ
QXXXXXXXXXXXXXXXXXXXXXXXXXXXXXXXXXXXXXXXXXXXXXXXXXXXXXXXXXXXXXXXXXXXXXZZZZZZQ
QZZZBZZZZZBZZZBZZZZZBXXZBZXXZZBZZZBZZZBZZZZZZZBZZZBZZZBZZZBZZZBZZZZZZZZZZZZZQ
QZZZZZZZZZZZZZZZZZZZZXXZZZZZZZZZZZZZZZZZZZZZZZZZZZZZZZZZZZZZZZZZZZZZZZZZZZZZQ
QZZZXXXXXXXXXXXXXXXXXXXXXXXXXXXXXXXXXXXXXXXXXXXXXXXXXXXXXXXXXXXXXXXXXXXXXXXXQ
QZZZZBZBZBZBZBZBZBZBZBZBZBZBZBZBZBZBZBZBZBZBZBZBZBZBZBZBZBZZZZZZZZZZZZZZZZZZQ
QXXXXXXXXXXXXXXXXXXXXXXXXXXXXXXXXXXXXXXXXXXXXXXXXXXXXXXXXXXXXZZZXXXXXXXXXXXXQ
QZZZZXXXZZXXXXXXXXXXXXXXZZZZZZZZZZZZZZZZZZZZZZZXXXXXXXXXXXXXZZZZXXXXXXXXXXXXQ
QZZZZZZZZZZZZZZZZZZZZXXXZZZBZZBZZBZBZZBZZBZZBZZBZZBZZBZZZBZZZZZZZXXXXXXXXXXXQ
QZZZZZZZZZZZBZBZBZBZBXXXZZZZZZZZZZZZZZZZZZZZZZZZZZZZZZZZZZZZZZZZZZZZZZZZZZZZQ
QZZZZZZZZZZXXXXXXXXXXXXXXXXXXXXXXXXXXXXXXXXXXXXXXXXXXXXXXXXXXXXXXXXXXXXXXXXXQ
QZZZZZZZZZZZZZZZZZZXXXBZZZZXXXXXXXXXXXXXXXXXXXXXXXZZZZZZZZZZZZZZZZZZZZZZZZZZQ
QXXXXXXXXXXXXXXXXXXXXXXXBZZZZZZZZZZZZZZZZXXZXXXXXXXXXXXXXXXXXXXXXXXXXXXXXXXXQ
QZBZZBZZBZZBZZBZZBZZBXXXXXXXBZZZZZZZZZZZZXXZZZZZZZZZZZZZZZZZZZZZZZZZZZZZZZZZQ
QXZZZZZZZZZZZZZZZZZZZZZZZZZXXXZZZZZZZZZZXXBZBZBZBZBZBZBZBZBZZZZZZZZZZZZZXXXXQ
QXXXXXXXXXXXXXXXXXXXXXXXXXXXXXXXXXXXXXXXXXXXXXXXXXXXXXXXXXXXXZZZXXXXXXXXXXXXQ
QZZZZZBZBZBZBZBZBXXXZZZZZZZZZZZZZZZZZZZZZZZZZZZZZZZZZZZXXXXXBZBZBZBZBZBZBZBZQ
QZZZZZXXXXXXXXXXXXXXXXXXXXXXXXXXXXXXXXXXXXXXXXXXXXXXXXXXXXXXXXXXXZZZZZZZZZZZQ
QZZZXXXXXXZZZZZZZZZZZZZZZZZZXXXXXZZZZZZZZZXXXXXXXZZZZZZZZZZZZZXXXXXXXXXXXXXXQ
QZZZZZZZZZZZZZZZZZZZZZZZZZZZZZZZZZZZZZZZZZZZZZZZZZZZZZZZZZZZZZZXXXZZZZZZ[]XXQ
QXXXXXXXXXXXXXXXXXXXXXXXXXXXXXXXXXXXXXXXXXXXXXXXXXXXXXXXXXXXXXXXXXXXXXXXXXXXQ
                                                                             