XXXXXXXXXXXXXXXXXXXXXXXXXXXXXXXXXXXXXXXXXXXXXXXXXXXXXXXXXXXXXXXXXXXXXXXXXXXXX
QZZBZBZBZBZBZBZBZBZBZBZBZBZBZBZBZBZBZBZBZBXXBZBZBZBZBZBZBZZBZZZBZZBZBZZZZZZZQ
QZZZZZZZZZZZZZZZZZZZZZZZZZZZZZZZZZZZZZZZZZZZZZZZZZZZZZZZZZZZZZZZZZZZZZZZZXXXQ
QXXXXXXXXXXXXXXXXXXXXXXXXXXXXXXXXXXXXXXXXXXXXXXXXXXXXXXXXXXXXXXXXXXXXXZZZZZZQ
QZZZZZZZZZZZZZZZZZZZZZZZZZXXZZZZZZZZZZZZZZZZZZZZZZZZZZZZZZZZZZZZZZZZZZZZZZZZQ
QZZZZZZZZZZZZZZZZZZZZZZZZZZZZZZZZZZZZZZZZZZZZZZZZZZZZZZZZZZZZZZZZZZZZZZZZZZZQ
QZZZXXXXXXXXXXXXXXXXXXXXXXXXXXXXXXXXXXXXXXXXXXXXXXXXXXXXXXXXXXXXXXXXXXXXXXXXQ
QZZZZZZZZZZZZZZZZZZZZZZZZZZZZZZZZZZZZZZZZZZZZZZZZZZZZZZZZZZZZZZZZZZZZZZZZZZZQ
QXXXXXXXXXXXXXXXXXXXXXXXXXXXXXXXXXXXXXXXXXXXXXXXXXXXXXXXXXXXXZZZXXXXXXXXXXXXQ
QZZZZXXXZZXXXXXXXXXXXXXXZZZZZZZZZZZZZZZZZZZZZZZXXXXXXXXXXXXXZZZZXXXXXXXXXXXXQ
QZZZZZZZZZZZZZZZZZZZZXXXZZZZZZZZZZZZZZZZZZZZZZZZZZZZZZZZZZZZZZZZZXXXXXXXXXXXQ
QZZZZZZZZZZZZZZZZZZZZZZZZZZZZZZZZZZZZZZZZZZZZZZZZZZZZZZZZZZZZZZZZZZZZZZZZZZZQ
QZZZZZZZZZZXXXXXXXXXXXXXXXXXXXXXXXXXXXXXXXXXXXXXXXXXXXXXXXXXXXXXXXXXXXXXXXXXQ
QZZZZZZZZZZZZZZZZZZZZZZZZZZXXXXXXXXXXXXXXXXXXXXXXXZZZZZZZZZZZZZZZZZZZZZZZZZZQ
QXXXXXXXXXXXXXXXXXXXXXXXZZZZZZZZZZZZZZZZZZZZXXXXXXXXXXXXXXXXXXXXXXXXXXXXXXXXQ
QZZZZZZZZZZZZZZZZZZZZZZZXXXXXXXXXXZZZZZZZZZZZZZZZZZZZZZZZZZZZZZZZZZZZZZZZZZZQ
QZZZZZZZZZZZZZZZZZZZZZZZZZZZZZZZZZZZZZZXXXXZZZZZZZZZZZZZZZZZZZZZZZZZZZZZXXXXQ
QXXXXXXXXXXXXXXXXXXXXXXXXXXXXXXXXXXXZZZZZZZXXXXXXXXXXXXXXXXXXXXXXXXXXXXXXXXXQ
QZZZZZZZZZZZZZZZZZZZZZZZZZZZZZZZZZZZZZZZZZZZZZZZZZZZZZZXXXXXZZZZZZZZZZZZZZZZQ
QZZZZZXXXXXXXXXXXXXXXXXXXXXXXXXXXXXXXXXXXXXXXXXXXXXXXXXXXXXXXXXXXZZZZZZZZZZZQ
QZZZXXXXXXZZZZZZZZZZZZZZZZZZXXXXXZZZZZZZZZXXXXXXXZZZZZZZZZZZZZXXXXXXXXXXXXXXQ
QZZZZZZZZZZZZZZZZZZZZZZZZZZZZZZZZZZZZZZZZZZZZZZZZZZZZZZZZZZZZZZZZZZZZZZZ[]XXQ
QXXXXXXXXXXXXXXXXXXXXXXXXXXXXXXXXXXXXXXXXXXXXXXXXXXXXXXXXXXXXXXXXXXXXXXXXXXXQ
                                                                             