XXXXXXXXXXXXXXXXXXXXXXXXXXXXXXXXXXXXXXXXXXXXXXXXXXXXXXXXXXXXXXXXXXXXXXXXXXXXX
XZZZZZZZZZZZZZZZZZZZZZZZZZZZZZZZZZZZZZZXXZZZZZZZZZZZZZZZZZZZZZZZZZZZZZZZZZZZX
XZZZZZZZZZZZZZZZZZZZZZZZZZZZZZZZZZZZZZZZZZZZZZZZZZZZZZZZZZZZZZZZZZZZZZZZZZZZX
XXXXXXXXXXXXXXXXXXXXXXXXXXXXXXXXXXXXXXXXXXXXXXXXXXXXXXXXXXXXXXXXXXXXXXZZZXXXX
XZZZZZZZZZZZZZZZZZZZZZZZZZXXZZZZZZZZZZZZZZZZZZZZZZZZZZZZZZZZZZZZZZZZZZZZZZZZX
XZZZZZZZZZZZZZZZZZZZZZZZZZZZZZZZZZZZZZZZZZZZZZZZZZZZZZZZZZZZZZZZZZZZZZZZZZZZX
XZZZXXXXXXXXXXXXXXXXXXXXXXXXXXXXXXXXXXXXXXXXXXXXXXXXXXXXXXXXXXXXXXXXXXXXXXXXX
XZZZZZZZZZZZZZZZZZZZZZZZZZZZZZZZZZZZZZZZZZZZZZZZZZZZZZZZZZZZZZZZZZZZZZZZZZZZX
XXXXXXXXXXXXXXXXXXXXXXXXXXXXXXXXXXXXXXXXXXXXXXXXXXXXXXXXXXXXXZZZXXXXXXXXXXXXX
XZZZZXXXZZXXXXXXXXXXXXXXZZZZZZZZZZZZZZZZZZZZZZZXXXXXXXXXXXXXZZZZXXXXXXXXXXXXX
XZZZZZZZZZZZZZZZZZZZZXXXZZZZZZZZZZZZZZZZZZZZZZZZZZZZZZZZZZZZZZZZZXXXXXXXXXXXX
XZZZZZZZZZZZZZZZZZZZZZZZZZZZZZZZZZZZZZZZZZZZZZZZZZZZZZZZZZZZZZZZZZZZZZZZZZZZX
XZZZZZZZZZZXXXXXXXXXXXXXXXXXXXXXXXXXXXXXXXXXXXXXXXXXXXXXXXXXXXXXXXXXXXXXXXXXX
XZZZZZZZZZZZZZZZZZZZZZZZZZZXXXXXXXXXXXXXXXXXXXXXXXZZZZZZZZZZZZZZZZZZZZZZZZZZX
XXXXXXXXXXXXXXXXXXXXXXXXZZZZZZZZZZZZZZZZZZZZXXXXXXXXXXXXXXXXXXXXXXXXXXXXXXXXX
XZZZZZZZZZZZZZZZZZZZZZZZXXXXXXXXXXZZZZZZZZZZZZZZZZZZZZZZZZZZZZZZZZZZZZZZZZZZX
XZZZZZZZZZZZZZZZZZZZZZZZZZZZZZZZZZZZZZZXXXXZZZZZZZZZZZZZZZZZZZZZZZZZZZZZXXXXX
XXXXXXXXXXXXXXXXXXXXXXXXXXXXXXXXXXXXZZZZZZZXXXXXXXXXXXXXXXXXXXXXXXXXXXXXXXXXX
XZZZZZZZZZZZZZZZZZZZZZZZZZZZZZZZZZZZZZZZZZZZZZZZZZZZZZZXXXXXZZZZZZZZZZZZZZZZX
XZZZZZXXXXXXXXXXXXXXXXXXXXXXXXXXXXXXXXXXXXXXXXXXXXXXXXXXXXXXXXXXXZZZZZZZZZZZX
XZZZXXXXXXZZZZZZZZZZZZZZZZZZXXXXXZZZZZZZZZXXXXXXXZZZZZZZZZZZZZXXXXXXXXXXXXXXX
XZZZZZZZZZZZZZZZZZZZZZZZZZZZZZZZZZZZZZZZZZZZZZZZZZZZZZZZZZZZZZZZZZZZZZZZZZ[]X
XXXXXXXXXXXXXXXXXXXXXXXXXXXXXXXXXXXXXXXXXXXXXXXXXXXXXXXXXXXXXXXXXXXXXXXXXXXXX
                                                                             